10000000000000000000000001
20000000000000000000000002
20000000000000000000000002
20000000000000000000000002
20000000000000000000000002
20000000000000000000000002
20000657000000000065700002
20000000000000000000000002
20000000065700657000000002
20000000000000000000000002
21114000000000000000031112
22222000000000000000022222
22222140000000000031122222
22222224000000000322222222
22222222111111111222222222
22222222222222222222222222