10000000000000000000000001
20000000000000000000000002
20000000000000000000000002
20000000000000000000000002
20000000000000000000000002
20000000000000000000000002
20000111000000000011100002
20000000000000000000000002
20000000011100111000000002
20000000000000000000000002
21111000000000000000011112
22222000000000000000022222
22222110000000000011122222
22222221000000000122222222
22222222111111111222222222
22222222222222222222222222