10000000000000000000000001
20000000000000000000000002
20000000000000000000000002
20000000000000000000000002
20000000000000000000000002
20000000000000000000000002
20000000000000000000000002
20000000000000000000000002
21111111111111111111111112
22222222222222222222222222
22222222222222222222222222
