10000000000000000000000000000000000002
20000000000000000000000000000000000002
20000000000000000000000000000000000002
20000000000000000000000000000000000002
20000000000000000000000000000000000002
20000000000000000000000000000000000002
20000000000000000000000111100000000002
20000000000000100000000222210000000002
20000001000000200000000222221000000002
21111112111111211111111222222111111112
22222222222222222222222222222222222222
22222222222222222222222222222222222222